1111111111
11000C00C1
1C010E1001
10111C1011
1P01CMC001
11C00C01C1
1111111111
