1111111111111111111111111111
100001C100000000C100000010E1
1000010100001011110101101011
1101000000001000000101C01001
1C01011110000MC0000101111101
11110001001010000100000000C1
1P0C0001C01000010C0000001001
1111111111111111111111111111
