1111111111111
10000000C00P1
1C11M01011011
111E0C1010001
1C11000000101
100001C1C01C1
1111111111111
